NO ./path_to_the_north_texture
SO ./path_to_the_south_texture
WE ./path_to_the_west_texture
EA ./path_to_the_east_texture
F 220,100,0
C 225,30,0
        1111111111111111111111111
        1010000000110000000000001
        1011000001110000000000001
        1001000000000000000000001
11111111101101001110000000000001
10000000001100S001110111111111111
11110111101111011100000010001
11110111111111111101010010001
110000001101 1011100000010001
100000000001 1000110000010001
100000000001 10001101010010101
110000011101101111101111101111
11110111 1110101 101111010101
11111111 1111111 111111111111