NO ./path_to_the_north_texture
SO ./path_to_the_south_texture
WE ./path_to_the_west_texture
EA ./path_to_the_east_texture
F 220,100,0
C 225,30,0
        1111111111111111111111111
        1000000000110000000000001
        1011000001110000000000001
        1001000000000000000000001
111111111011000001110000000000001
100000000011000001110111111111111
111101111W1111011100000010001
11110111111111111101010010001
110000001101 1011100000010001
100000000001 10001100000010001
100000000001 10001101010010101
1100000111011011111011111N01111
11110111 1110101 101111010101
11111111 1111111 111111111111