
NO ./path_to_the_north_texture.xpm
SO ./path_to_the_south_texture.....xpm
WE ./path_to_the_west_texture.xpm
EA ./path_to_the_east_texture.xpm

F 229,100,0
C 295,30,0
        

111111
100101
1011D1
1100N1
111111



















                 

                  
                   
                    
                     
                      
                       
