WE textures/north.xpm
NO ../../textures/north.xpm
SO ../../textures/north.xpm
EA ../../textures/north.xpm

F 229,100,30
C 255,30,20


        1                
       1D11                     
      10E1111
     1010101 11111
    1111D1111
11111  111111111111
    1     1












   
     
      

       
        
         
          
           

             
              
               
               
