NO ./path_to_the_north_texture
SO ./path_to_the_south_texture
WE ./path_to_the_west_texture
EA ./path_to_the_east_texture

F 229,100,0
C 225,30,0
        
        1                
       1111                     
      100S11
     11111111
    1101D00001
 111111111111111111                                                                               