NO ./path_to_the_north_texture.xpm
SO ./path_to_the_south_texture.xpm
WE ./path_to_the_west_texture.xpm
EA ./path_to_the_east_texture..xpm

F 229,100,0

C 255,30,25

C 0,30,0

F 0,100,0
        
        1                
       1D11                     
      10E111
     1D101  11111
    1101D11101
11111111111111111
