NO ./path_to_the_north_texture
SO ./path_to_the_south_texture
WE ./path_to_the_west_texture
EA ./path_to_the_east_texture



F 259,100,0
C 225,30,0
        
        1
       11
      101
     1001
    11001
   111111   