NO                      ./north.xpm
 SO               ./south.xpm
WE ./west.xpm
EA ./east.xpm

 F     100,150,200
 C 50,75,125

1111111111111111
1N1 10010000D11
1011111 11110111
1D00001100000011
1111111111111111
