NO                      ./north.tex
 SO               ./south.tex
WE ./west.tex
EA ./east.tex

 F     100,150,200
 C 50,75,125

        1111111
       10000001
      100000001
     1000000001
    10000000001
   100000000001
  1000000000001
 10000000000001
10000000000N001
111111111111111
